2 2 2 2 2 2 2 2 2 2 2 2 2 13 13 13 13 14 13 13 13 13 2 2 2 2 2 2 2 2 2 2 2 2 10 4 11 2 2 2 2 2 2 2 2 2 2 2 2 2 
2 2 2 2 2 2 2 2 2 2 2 2 2 13 14 14 14 14 14 14 14 13 2 2 2 2 2 2 2 2 2 2 2 0 10 4 11 0 0 2 2 2 2 2 2 2 2 0 0 2 
2 2 2 2 2 2 2 2 2 2 2 2 2 13 14 14 14 14 14 14 14 13 2 2 2 2 2 2 2 2 2 2 0 19 19 19 19 19 0 2 2 2 2 2 2 2 2 0 0 2 
2 2 2 2 2 2 2 2 2 2 2 2 2 13 14 14 14 14 14 14 14 13 2 2 2 2 2 2 2 2 2 0 0 0 10 4 11 0 0 2 2 2 2 2 2 0 0 0 0 2 
2 2 2 2 2 2 2 2 2 2 2 2 2 13 14 14 14 14 14 14 14 13 2 2 2 2 2 2 2 2 0 0 0 2 10 4 11 0 2 2 2 2 2 0 0 0 0 2 2 2 
2 2 2 2 2 2 2 2 2 2 2 2 2 13 14 14 14 14 14 14 14 13 2 2 2 2 2 2 2 0 0 0 2 2 10 4 11 0 2 2 2 0 0 0 2 2 2 2 2 2 
2 2 2 2 2 2 2 2 2 2 2 2 2 13 13 13 13 14 13 13 13 13 2 2 2 2 2 2 0 0 0 2 2 2 10 4 11 0 2 2 0 0 0 2 2 2 2 2 2 2 
2 2 2 2 2 2 2 2 2 2 2 2 2 2 2 2 0 14 0 2 2 2 2 2 2 2 2 0 0 0 2 7 12 12 17 4 11 0 2 0 0 0 2 2 2 2 2 2 2 2 
2 2 2 2 2 2 2 2 2 2 2 2 2 2 2 2 0 14 0 2 2 2 2 2 2 2 0 0 0 0 0 10 4 4 4 4 11 0 2 0 0 0 2 2 2 2 2 2 2 2 
2 2 2 2 2 2 2 2 2 2 2 2 0 2 2 2 0 14 0 2 2 2 2 2 2 2 2 0 0 0 0 10 4 16 9 9 6 0 2 0 0 0 0 0 0 0 0 0 0 2 
2 2 2 2 2 2 0 0 2 14 14 14 14 14 14 0 0 14 0 2 2 2 2 2 2 2 2 0 0 0 0 10 4 11 2 2 2 0 2 0 0 0 0 0 0 0 0 0 0 2 
2 2 2 2 2 2 2 0 0 14 0 0 0 0 14 0 0 14 2 2 2 2 2 2 2 2 2 0 0 0 0 10 4 11 2 2 2 0 2 2 2 2 2 2 2 2 0 0 0 2 
2 2 2 2 2 2 2 2 0 14 0 0 0 0 14 14 14 14 2 2 2 2 2 2 2 2 2 0 0 0 0 10 4 11 2 2 0 0 0 0 0 0 0 0 2 2 0 0 0 2 
2 2 2 2 2 2 2 2 2 14 0 0 0 0 0 0 0 0 0 2 2 2 2 2 2 2 2 0 0 0 0 10 4 11 2 2 2 0 0 0 0 0 0 0 0 0 0 0 0 2 
2 2 2 2 2 2 2 2 2 14 0 0 0 0 2 2 2 0 0 0 2 2 2 2 2 2 2 0 0 0 0 10 4 11 2 2 2 0 0 0 0 0 0 0 0 0 0 0 0 2 
2 2 2 2 2 2 2 2 2 14 0 0 2 2 2 2 2 2 0 0 2 2 2 2 2 2 2 0 0 0 0 10 4 11 2 2 2 2 2 2 2 2 2 2 2 2 2 2 2 2 
2 0 0 0 0 0 2 2 2 14 0 0 2 2 2 2 2 2 0 0 0 0 0 0 0 0 0 0 0 0 0 10 4 18 12 12 12 12 12 12 12 12 12 12 12 12 12 12 12 12 
2 0 0 0 0 0 0 2 2 14 0 2 2 2 2 2 2 2 2 2 2 0 0 0 0 0 0 0 2 2 0 10 4 4 4 4 4 4 4 4 4 4 4 4 4 4 4 4 4 4 
2 0 0 2 2 0 0 0 2 14 2 2 2 2 2 2 2 2 2 2 2 2 2 2 2 2 2 2 2 2 2 5 9 9 9 9 9 9 9 9 9 9 9 9 9 9 9 9 9 9 
2 0 0 2 2 2 0 0 2 14 2 2 2 2 2 2 2 2 2 2 0 0 2 2 2 2 2 2 2 2 2 2 2 2 2 2 2 2 2 2 2 2 2 2 2 2 2 2 2 2 
2 0 0 0 2 2 0 0 0 0 0 0 0 0 2 2 0 0 0 0 0 0 0 0 0 2 2 2 2 2 2 2 2 2 2 2 2 2 2 2 2 2 2 2 2 2 2 2 2 2 
2 0 0 0 0 2 2 0 0 0 0 0 0 0 0 0 0 0 0 0 2 2 0 0 0 0 2 2 2 2 2 2 2 2 2 2 2 2 2 2 2 2 2 2 2 2 2 2 2 2 
2 2 2 0 0 0 2 2 0 0 0 0 2 0 0 0 0 2 2 2 2 2 2 2 0 0 0 2 2 2 2 2 2 2 2 2 2 2 2 2 2 2 2 2 3 3 3 3 3 3 
2 2 2 2 0 0 0 2 2 0 0 0 2 2 2 2 2 2 2 2 2 2 2 2 2 0 0 2 2 2 2 2 2 2 2 2 2 2 2 2 2 2 2 2 3 1 1 1 1 3 
2 2 2 2 2 0 0 0 2 2 0 0 2 2 2 2 2 2 2 2 2 2 2 2 2 2 0 0 2 2 2 2 2 2 2 2 2 2 2 2 2 2 2 2 3 1 1 1 1 3 
2 2 2 2 2 2 0 0 0 2 0 0 0 2 2 2 2 2 2 2 2 2 2 2 2 2 2 0 2 2 2 2 2 1 1 1 1 1 1 1 1 1 1 1 1 1 1 1 1 1 
2 2 2 2 2 2 0 0 0 2 0 0 0 0 0 2 2 2 2 2 2 2 2 2 2 2 2 1 2 2 2 2 2 1 0 0 0 2 2 2 2 2 2 2 3 1 1 1 1 3 
2 2 2 2 2 2 0 0 0 2 2 2 0 0 0 0 0 2 2 2 2 2 2 2 2 2 2 1 2 2 2 2 2 1 0 2 2 2 2 2 2 2 2 2 3 1 1 1 1 3 
2 2 2 2 2 2 0 0 0 2 2 2 2 0 0 0 0 2 2 2 2 2 2 2 2 2 2 1 2 2 2 2 2 1 2 2 2 2 2 2 2 2 2 2 3 3 3 3 3 3 
2 2 2 2 2 2 0 0 0 2 2 2 2 2 2 2 0 0 2 2 2 2 2 2 2 2 2 1 2 2 2 2 2 1 2 2 2 2 2 2 2 2 2 2 2 2 2 2 2 2 
2 2 2 2 2 2 0 0 0 2 2 2 2 2 2 2 0 0 0 2 2 2 2 2 2 2 2 1 1 1 1 1 1 1 2 2 2 2 2 2 2 2 2 2 2 2 2 2 2 2 
2 2 2 2 2 2 0 0 0 2 2 2 2 2 2 2 2 0 0 2 2 2 2 2 2 2 2 2 2 2 2 2 2 2 2 2 2 2 2 2 2 2 2 2 2 2 2 2 2 2 
2 2 2 2 2 2 0 0 0 2 2 2 2 2 2 2 2 0 0 2 2 2 2 2 2 2 2 2 2 2 2 2 2 2 2 2 2 2 2 2 2 2 2 2 2 2 2 2 2 2 
2 2 2 2 2 2 0 0 0 2 2 2 2 2 2 2 2 0 0 2 2 2 2 2 2 2 2 2 2 2 2 2 2 2 2 2 2 2 2 0 0 0 2 2 2 2 2 2 2 2 
2 2 2 2 2 2 0 0 0 2 2 2 2 2 2 2 2 0 0 2 2 2 2 2 2 2 2 2 2 2 2 2 2 2 2 2 0 0 0 0 0 0 2 2 2 2 2 2 2 2 
3 3 3 3 3 3 0 0 0 2 2 2 2 2 2 2 2 0 0 0 0 0 2 2 2 2 2 2 2 2 2 2 2 2 2 0 0 0 0 0 0 2 2 2 2 2 2 2 2 2 
3 1 1 1 1 3 0 0 0 2 2 2 2 2 2 2 2 0 0 0 0 0 0 0 0 0 0 0 0 0 0 0 0 0 0 0 0 0 0 2 2 2 2 2 2 2 2 2 2 2 
3 1 1 1 1 3 0 0 0 2 2 2 2 2 2 2 2 2 2 2 2 0 0 0 0 0 0 0 0 0 0 0 0 0 0 0 0 0 2 2 2 2 2 2 2 2 2 2 2 2 
3 1 1 1 1 1 0 0 0 2 2 2 2 2 2 2 2 2 2 2 0 0 0 2 7 12 12 12 12 12 12 12 12 12 12 12 12 12 8 2 2 2 2 2 2 2 2 2 2 2 
3 1 1 1 1 3 0 0 2 2 2 2 2 2 2 2 2 0 0 0 0 0 2 2 10 4 4 4 4 4 4 4 4 4 4 4 4 4 11 2 2 2 2 2 2 2 2 2 2 2 
3 1 1 1 1 3 0 2 2 2 2 2 2 2 2 2 2 0 0 0 0 0 2 2 10 4 4 4 4 4 4 4 4 4 4 4 4 4 11 2 2 2 2 2 2 2 2 2 2 2 
3 3 3 3 3 3 2 2 2 2 2 2 2 2 2 0 0 0 0 2 2 2 2 2 10 4 4 4 4 4 4 4 4 4 4 4 4 4 11 2 2 2 2 2 2 2 2 2 2 2 
2 2 2 2 2 2 2 2 2 2 2 2 2 2 2 0 0 2 2 2 2 2 2 2 10 4 4 4 4 4 4 4 4 4 4 4 4 4 11 2 2 2 2 2 2 2 2 2 0 2 
2 2 2 2 2 2 2 2 2 2 2 2 2 2 2 0 0 2 2 2 2 2 2 2 10 4 4 4 4 4 4 4 4 4 4 4 4 4 11 2 2 2 2 2 0 0 0 0 0 2 
2 2 2 2 2 2 2 2 2 2 2 2 2 2 2 0 0 2 2 2 2 2 2 2 10 4 4 4 4 4 4 4 4 4 4 4 4 4 11 2 2 2 0 0 0 0 0 0 0 2 
2 2 2 2 2 2 2 2 2 2 2 2 2 2 2 0 0 2 2 2 2 2 2 2 5 9 9 9 9 9 9 9 9 9 9 9 9 9 6 2 2 0 0 0 0 0 2 0 0 2 
2 2 2 2 2 2 2 2 2 2 2 2 2 2 2 0 0 2 2 2 2 2 2 2 2 2 2 2 2 2 2 2 2 2 2 2 2 2 2 2 0 0 0 0 2 2 2 0 0 2 
2 2 2 2 2 2 2 2 2 2 2 2 2 2 2 0 0 0 0 0 0 0 0 0 0 0 0 0 0 0 0 0 0 0 0 0 0 0 0 0 0 0 2 2 2 2 0 0 0 2 
2 2 2 2 2 2 2 2 2 2 2 2 2 2 2 0 0 0 0 0 0 0 0 0 0 0 0 0 0 0 0 0 0 0 0 0 0 0 0 0 0 2 2 2 0 0 0 0 0 2 
2 2 2 2 2 2 2 2 2 2 2 2 2 2 2 2 2 2 2 2 2 2 2 2 2 2 2 2 2 2 2 2 2 2 2 2 2 2 2 2 2 2 2 2 2 2 2 2 2 2 
